----------
----------
----------
----------
----------
----------
----------
----------
----------
----------
----------
----------
--------F-
--------#-
XXXXXXXXXX
XXXXXXXXXX