----------
----------
----------
----------
----------
----------
----------
----------
---#------
--##--oo--
-###------
####------
####------
####--k---
XXXXXXXXXX
XXXXXXXXXX
