----------
----------
----------
----------
----------
----------
S---------
-------TT-
-------TT-
-------XX-
---TT-----
---TT-----
---TT-----
k--TT-----
XXXXXXXXXX
XXXXXXXXXX
