----------
----------
----------
----------
----------
----------
----------
----------
----------
----------
----------
--------K-
TTTT------
TTTT------
XXXXXXXXXX
XXXXXXXXXX
