----------
----------
----------
----------
----------
----------
----------
----------
----------
----------
----------
----------
----------
--kkk-----
XXXXXXXXXX
XXXXXXXXXX
