----------
----------
----------
----------
----------
----------
----------
----------
----------
----------
------!---
----------
----------
----------
XXXXXXXXXX
XXXXXXXXXX