----------
----------
----------
----------
-K--------
----------
-##-------
###-------
###-------
###-------
###-------
###-------
###-------
###-------
XXXXXXXXXX
XXXXXXXXXX
