----------
----------
----------
----------
----------
-----oooo-
-----%%%%-
------||--
------||--
SSS---||--
------||--
----U-||--
------||--
------||--
----%%%%%-
-----|||--
