----------
----------
----------
----------
----------
----------
----------
----------
----------
----o----o
----------
----------
----------
----------
XXX---XX--
XXX---XX--
