----------
----------
----------
---oo-----
----------
----------
--SSSS----
----------
----------
----------
------%%%%
-------|||
-------|||
-------|||
%%%----|||
||-----|||
