----------
----------
----------
----------
----------
----------
--------##
-------###
------####
-----#####
----######
---#######
t-########
t#########
XXXXXXXXXX
XXXXXXXXXX