----------
----------
----------
----------
----------
----------
----------
------TT--
------TT--
------TT--
-----SXXS-
----------
TT--------
TT--------
XXXXXXXXXX
XXXXXXXXXX
