----------
----------
----------
----------
----------
----------
----------
----------
----------
----------
------tt--
------tt--
------tt--
-g----tt--
XXXXXXXXXX
XXXXXXXXXX