----------
----------
----------
----------
----------
----------
----------
----------
----------
----------
----------
----TT----
----TT----
----TT----
XXXXXXXXXX
XXXXXXXXXX
