----------
----------
----------
----------
----------
----------
----------
----------
----------
----------
-------tt-
T------tt-
T------tt-
T------tt-
XXXXXXXXXX
XXXXXXXXXX
