----------
----------
----------
----------
----------
----------
----------
----------
----------
----------
----------
----------
----------
------ggg-
XXXXXXXXXX
XXXXXXXXXX
