----------
----------
----------
----------
----------
----------
----------
----------
----------
SSSSS-----
----------
----------
----------
----------
XXXXXXXXXX
XXXXXXXXXX
