----------
----------
----------
----------
----------
----------
----------
----------
----------
t---------
t---------
t---------
t---------
t-----k--g
XXXXXXXXXX
XXXXXXXXXX
