----------
----------
----------
----------
----------
----------
------2---
----------
----------
o---------
------2---
----------
----------
----y--y--
XXXXXXXXXX
XXXXXXXXXX
