----------
----------
----------
----------
----------
--k-------
--##------
-###------
####------
####------
####------
####------
####------
####------
XXXXXXXXXX
XXXXXXXXXX
