----------
----------
----------
----------
----------
----------
----------
----------
--TT------
--TT------
--TT------
--TT-----T
T-TT-----T
T-TT---k-T
XXXXXXXXXX
XXXXXXXXXX
