----------
----------
----------
----------
----------
K---------
SS----1---
----------
----------
----------
SS--------
------TT--
------TT--
------TT--
XXXXXXXXXX
XXXXXXXXXX
