----------
----------
----------
----------
----------
----------
----------
----------
----------
----------
----------
----------
-------B--
-------b--
XXXXXXXXXX
XXXXXXXXXX
