----------
----------
----------
----------
----------
----------
----------
----------
-------B--
-------b--
-----SS#CS
----------
---------K
----------
XXXXXXXXXX
XXXXXXXXXX
