----------
----------
----------
----------
----------
----------
----------
----------
----------
---1------
T---------
T----TT---
T----TT---
T---kTT---
XXXXXXXXXX
XXXXXXXXXX
