----------
----------
----------
----------
----------
----------
----------
----------
---------y
---------X
--------XX
-------XXX
------XXXX
-----XXXXX
XXXXXXXXXX
XXXXXXXXXX
