----------
----------
----------
----------
----------
----------
----------
----------
----------
----------
------%%%%
-------||-
-------||-
-------||-
X--%%%%||%
X---||-||-
