----------
----------
----------
----------
----------
----------
--SSSSS---
----------
----------
----------
-------2--
-----TT---
t----TT--T
t----TT--T
XXXXXXXXXX
XXXXXXXXXX
