----------
----------
----------
----------
----------
----------
----------
----------
----------
----------
-----SSS--
----------
----------
----------
XXXXXXXXXX
XXXXXXXXXX
