----------
----------
----------
----------
----------
----------
----------
----------
----------
----------
#---------
##--------
###------#
####----##
XXXXXXXXXX
XXXXXXXXXX