----------
----------
----------
----------
----------
----------
----------
----------
----------
----------
----------
----K-----
--------K-
----------
XX-X-XX-X-
XX-X-XX-X-
