----------
----------
----------
----------
----------
----------
%---------
----------
------SSS-
----------
%%%%%-----
-|||------
-|||------
-|||------
%|||------
-|||------
