----------
----------
----------
----------
----------
----------
----------
----------
----------
----------
-------tt-
-------tt-
-------tt-
---g-g-tt-
XXXXXXXXXX
XXXXXXXXXX