----------
----------
----------
----------
----------
ooooo-----
----------
--------SS
-SSSS-----
----------
----------
----------
----%%%%%-
-----|||--
%%---|||--
|----|||--
