----------
----------
----------
----------
----------
----------
-----US---
----------
----------
---SS-----
---------S
----------
TT--------
TT--------
XXXXXX-X-X
XXXXXX-X-X
