----------
----------
----------
----------
----------
----------
----------
----------
----------
------oo--
----------
----------
----------
----------
XXXX------
XXXX------
