----------
----------
----------
----------
----------
----------
SS--------
----------
----------
----------
SS--------
------#-TT
-----##-TT
----###-TT
XXXXXXX-XX
XXXXXXX-XX
