----------
----------
----------
----------
----------
----------
------SSoo
----------
----------
----------
%%%%%%----
-||||-----
-||||-----
-||||-----
-||||-----
-||||-----
