----------
----------
----------
----------
----------
----------
----y-----
--#SSS----
-##-------
###1------
###-------
###--SSS--
###-------
###-------
XXXXXX---X
XXXXXX---X
