----------
----------
----------
----------
----------
----------
----------
----------
----------
----------
----------
----------
------#---
------#-k-
-XXXXXXXXX
-XXXXXXXXX
