----------
----------
----------
----------
----------
----------
----------
----------
----------
----------
----------
-------K--
--B-------
--b-------
XXXXXXXXXX
XXXXXXXXXX
