----------
----------
----------
----------
----------
----------
----------
----------
----------
----------
---------T
---------T
---------T
--ggg----T
XXXXXXXXXX
XXXXXXXXXX
