----------
----------
----------
----------
----------
----------
---------#
---------#
------y--#
------#--#
-----##--#
---y###--#
---####--#
--#####--#
XXXXXXX--X
XXXXXXX--X
