----------
----------
----------
----------
----------
----------
-----SSS--
----------
----------
----------
-#---SSS--
-#--------
-##-------
-##-------
XXXXXXXXXX
XXXXXXXXXX
