----------
----------
----------
----------
---------o
----------
----------
----SSS---
oo--------
----------
SS--------
----------
----------
----------
----------
----------
