----------
----------
----------
----------
----------
----------
##--------
##--------
##--------
##--------
##--------
##--------
##--------
##--------
XXXXXXXXXX
XXXXXXXXXX
