----------
----------
----------
----------
----------
----------
----------
----------
----------
----------
----------
----------
-----B----
-----b----
XXXXXXXXXX
XXXXXXXXXX
