----------
----------
----------
----U-----
----------
----------
----------
------SS--
----------
--SS------
---------#
--------##
-------###
------####
XXXXX-XXXX
XXXXX-XXXX
