----------
----------
----------
----------
----------
----------
----------
----------
----------
o---oo----
----------
----------
----------
----------
--X----XXX
--X----XXX
