----------
----------
----------
----------
----------
----------
----------
----------
-------TT-
-TT----TT-
-TT----XX-
-TT-------
-TT-------
-TT-------
XXXXXXXXXX
XXXXXXXXXX
