----------
----------
----------
----------
----------
----------
----------
----------
----------
----------
-##--#----
###--##---
###--###--
###--####-
XXX--XXXXX
XXX--XXXXX