----------
----------
----------
----------
----------
----------
----------
----------
----------
----------
----------
----------
----------
-k----kkk-
XXXXXXXXXX
XXXXXXXXXX
