----------
----------
----------
----------
----------
----------
----------
----------
----------
----------
----------
-----K---B
---------b
---------B
XXXXXXXXXX
XXXXXXXXXX
