----------
----------
----------
----------
----------
----------
----------
----------
----------
----------
--------TT
--------TT
--------TT
----ggg-TT
XXXXXXXXXX
XXXXXXXXXX
