----------
----------
----------
----------
----------
----------
----------
----------
----------
-----oooo-
----------
----------
----------
----------
%%%%%%%-%%
||||||---|
