----------
----------
----------
SSSSSSSSSS
----------
----------
----------
----------
----------
---------C
---#-#----
-#-#-#-#--
-#-#-#-#--
-#-#-#-#-E
XXXXXXXXXX
XXXXXXXXXX
