----------
----------
----------
SSSSSSSSSS
SSSS--SSSS
SSSS--SSSS
--SS---S--
--SS---S--
--SS---S--
ooSS---SoU
SSSS---SSS
----------
----------
k--g-g----
XXXXXXXXXX
XXXXXXXXXX
