----------
----------
----------
SSSSSSSSSS
------SSSS
---g--SSSS
--SS------
--SS------
--SS------
--SC--g-g-
--SS--SSSS
----------
----------
----------
XXXXXXXXXX
XXXXXXXXXX
