----------
----------
----------
SSSSSSSSSS
----------
----------
----------
----------
---------S
---------S
---------S
-#--------
-#-#------
-#-#------
XXXXXXXXXX
XXXXXXXXXX
