----------
----------
----------
SSSSSSSSSS
----------
----------
----------
----------
----------
----------
----------
--SS------
--SS------
--SS------
--XX--XXXX
--XX--XXXX
