----------
----------
----------
SSSSSSSSSS
----------
----------
----------
----------
----------
----------
---------T
---TT----T
---TT----T
g--TT----T
XXXXXXXXXX
XXXXXXXXXX
