----------
----------
----------
----------
----------
----------
-------##-
-------##-
-----####-
-----####-
---######-
---######-
---######-
---######-
XXXXXXXXXX
XXXXXXXXXX
