----------
----------
----------
----------
----------
--------oo
oo--------
----------
----------
-SSS------
---------S
----------
----------
----------
----------
----------
