----------
----------
----------
----------
----------
----------
----------
----------
----------
-------SSS
%---------
----------
----------
---------r
----XXXXXX
----XXXXXX
