----------
----------
----------
----------
----------
----------
-----g----
-%%%%%%---
--||||----
--||||----
--||||----
--||||----
--||||----
--||||----
--||||----
--||||----
