----------
----------
----------
----------
----------
----------
----------
----------
----------
----------
----------
-------#--
---K---#--
-------#--
XXXXX--XXX
XXXXX--XXX
