----------
----------
----------
----------
----------
----------
----SSCSS-
----------
----------
----------
--QQQQ--QQ
----------
----------
----------
XXXXXXXXXX
XXXXXXXXXX
