----------
----------
----------
----------
---XX-----
---XX-----
---XX-----
---XX-----
---XX-----
---XX-----
---XX-----
---XX-----
---XX-----
---XX-----
XXXXXXXXXX
XXXXXXXXXX
