----------
----------
----------
----------
----------
----------
----------
----------
----------
----------
----------
----------
----------
k---------
XX---XXXXX
XX---XXXXX
