----------
----------
----------
----------
----------
----------
------QQQQ
----------
----------
--------k-
T-----?QQQ
T---------
T---------
T---------
XXXXXXXXXX
XXXXXXXXXX
