----------
----------
----------
----------
----------
----------
-LSSS-----
----------
----------
----------
-2-----#--
-------#--
-------##-
--kk---##-
XXXXXXXXXX
XXXXXXXXXX
