----------
----------
----------
----------
----------
----------
--------US
----------
----------
------E---
-----TT---
-----TT--t
-----TT--t
--g--TT--t
XXXXXXXXXX
XXXXXXXXXX
