----------
----------
----------
----------
----------
----------
Q---------
----------
----------
----------
Q---------
----------
----------
---gg----k
XXXXXXXXXX
XXXXXXXXXX
