----------
----------
----------
----------
----------
----------
----------
----------
----------
----------
---------#
--------##
-------###
------####
--XXXXXXXX
--XXXXXXXX
