----------
----------
----------
----------
----------
----------
-----1----
----------
----------
-----ggg--
#########-
--------#-
--------#-
--------#-
--------X-
--------X-
