----------
----------
----------
----------
----------
----------
----------
----------
----------
--Q--?----
---------S
----------
----------
--------K-
XXXXXXXXXX
XXXXXXXXXX
