----------
----------
----------
----------
----------
----------
S---------
----------
----------
----------
S--------S
----------
----------
g--------K
XXXXXXXXXX
XXXXXXXXXX
