----------
----------
----------
----------
----------
----k-----
---SQS--SQ
----------
----------
----------
---SQS--S?
----------
----------
-k------gg
XXXXXXXXXX
XXXXXXXXXX
