----------
----------
----------
----------
----------
----k-----
---##-----
--###-----
k####-----
#####-----
#####-----
#####-----
#####-----
#####-----
XXXXXXXXXX
XXXXXXXXXX
