----------
----------
----------
----------
----------
----------
----------
----------
----------
----------
SS--------
-K---TT---
-----TT---
-----TT---
XXXXXXXXXX
XXXXXXXXXX
