----------
----------
----------
----------
----------
----------
----------
----------
----------
----------
-TT-------
-TT-------
-TT-------
gTT-------
XXXXXXXX--
XXXXXXXX--
