----------
----------
----------
----------
----------
----------
----------
----------
--------#-
--k-----#-
CSSS----#-
-K-----##-
-------##-
---K---##-
XXXXXXXXX-
XXXXXXXXX-
