----------
----------
----------
----------
----------
----------
-SSSS-----
----------
----------
-----SSSS-
----------
----------
----------
----------
---------X
---------X
