----------
----------
----------
----------
---o------
--%%%-----
---|--o---
---|--SSSS
%--|------
---|------
---|------
---|------
---|-----%
---|------
%%%%%%----
|||||-----
