----------
----------
----------
-oo-------
%%%%------
-||-------
-||-------
-||--SSS--
-||-------
-||-------
-||-------
-||-------
%||-------
-||-------
-||-------
-||-------
