----------
----------
----------
----------
----------
----------
----------
----------
-------%%%
--------||
--------||
---%%%%%||
----|||-||
----|||-||
X---|||-||
X---|||-||
