----------
----------
----------
----------
----------
----------
-------Q-Q
----------
----------
----------
-------Q-Q
----------
----------
----------
XXXXXXXXXX
XXXXXXXXXX
