----------
----------
----------
----------
----------
----------
----------
----------
----------
----------
----------
----------
----------
-------y--
XXXXXXXXXX
XXXXXXXXXX
