----------
----------
----------
----------
----------
----------
----------
----------
----------
----------
----------
--#-------
--#-------
--#----y--
XXX--XXXXX
XXX--XXXXX
