----------
----------
----------
----------
----------
--------y-
--------##
------y###
------####
-----#####
----######
---#######
--########
-#########
XXXXXXXXXX
XXXXXXXXXX
