----------
----------
----------
----------
----------
----------
----------
--------oo
----------
----------
----------
------#---
------#---
------#---
XXXXXXXXXX
XXXXXXXXXX
