----------
----------
----------
----------
----------
----------
----------
----------
----------
-----oo---
----o--o--
----------
----------
----------
XXXXXXXXXX
XXXXXXXXXX
