----------
----------
----------
----------
----------
----------
----------
----------
----------
----------
----------
----------
----------
y---------
XXXXXXXXXX
XXXXXXXXXX
