----------
----------
----------
----------
----------
----------
----------
oo--------
----------
----------
---------T
---------T
---------T
------y--T
XXXXXXXXXX
XXXXXXXXXX
