----------
----------
----------
SSSSSSSSSS
----------
----------
----------
--------TT
--------TT
--------TT
------SCTT
--TT----TT
--TT----TT
--TT---kTT
XXXXXXXXXX
XXXXXXXXXX
