----------
----------
----------
SSSSS-----
----------
----------
----------
----------
----------
----------
----------
----#-----
---##-SSS-
--###-----
XXXXX-----
XXXXX-----
