----------
----------
----------
SSSSSSSSSS
SSSSSS----
SSSSSS----
SSSSSS----
----------
----------
oo--------
SS----#---
-----##---
----###---
---####--k
XXXXXXXXXX
XXXXXXXXXX
