----------
----------
----------
SSSSSSSSSS
SSSSSSSS--
SSSCSSSS--
SSSSSSSS--
----------
----------
---ggg----
SSSSSSSS--
SSSSSSSS--
SSSSSSSS--
SSSSSSSS--
XXXXXXXXXX
XXXXXXXXXX
