----------
----------
----------
SSS-----SS
----------
----------
US--------
----------
----SSS---
----------
SSS-------
----------
----------
----------
XXX------X
XXX------X
