----------
----------
----------
SSSSSSSSSS
----------
----------
----------
----------
----------
----------
----------
--------TT
-tt-----TT
-tt----kTT
XXXXXXXXXX
XXXXXXXXXX
