----------
----------
----------
SSSSSSSSSS
----------
----------
----------
----------
----------
----------
--TT------
--TT------
--TT------
--TT------
XXXX--XXXX
XXXX--XXXX
