----------
----------
----------
SSSSSSSSSS
SSSSSSSSSS
SSSSSSSSSS
SSSSSSSSSS
S---------
S---------
--oooooooo
-USSSSSSSS
----------
----------
--------kk
XXXXXXXXXX
XXXXXXXXXX
