----------
----------
----------
SSSSSSSSSS
----------
----------
----------
----------
----------
----------
----------
----------
----------
----------
X--XX--X--
X--XX--X--
