----------
----------
----------
SSSSSSSSSS
----------
----------
----------
----------
----------
-------S--
SU--------
----TT---t
----TT---t
---kTT--kt
XXXXXXXXXX
XXXXXXXXXX
