----------
----------
----------
-------SSS
----------
----------
----CSS---
----------
SS--2-----
---2-2----
------2---
----------
----------
----------
---XXXXXXX
---XXXXXXX
