----------
----------
----------
----------
----------
----------
----##----
----##----
----##----
-#--##----
##--##----
##--##----
##--------
##--------
XXXXXXXXXX
XXXXXXXXXX
