----------
----------
----------
----------
----------
----------
----------
----------
----------
----------
--#LSS----
--#-------
--#-------
kk#-------
XXXXXXX---
XXXXXXX---
