----------
----------
----------
----------
----------
----------
----------
----------
----------
----------
----------
--K-------
----------
---------g
XXXXXXXXXX
XXXXXXXXXX
