----------
----------
----------
----------
----------
----------
-----SUS--
----------
----------
----------
----#####-
----#-----
---K#-----
----#-----
XXXXXXX---
XXXXXXX---
