----------
----------
----------
----------
----------
----------
----------
----------
----------
----------
----------
-#--------
-#--------
-#----ggg-
-XXXXXXXXX
-XXXXXXXXX
