--------

--------

--------

--------

--------

--------

--------

--------

--------

--------

--------

--------

----F---

----#---

XXXXXXXX

XXXXXXXX
