----------
----------
----------
----------
----------
----------
----------
----------
----------
----------
----------
T-----TT--
T-----TT--
T-----TT--
XXXX--XXXX
XXXX--XXXX
