----------
----------
----------
----------
----------
----------
----------
----------
----------
----------
----------
----------
----------
k---ggg---
XXXXXXXXXX
XXXXXXXXXX
