----------
----------
----------
----------
----------
----------
----------
----------
-------g--
-------#--
S-----##--
-----###--
----####--
---#####--
XXXXXXXXXX
XXXXXXXXXX
