----------
----------
----------
----------
----------
----------
----------
----------
----------
----------
----------
--------g-
--------TT
--------TT
--XXXXXXXX
--XXXXXXXX
