----------
----------
----------
----------
----------
----------
----------
----------
----------
----------
----------
-----1@---
----------
k---------
XX---XXXXX
XX---XXXXX
