----------
----------
----------
----------
----------
----------
----------
----------
----------
----------
----------
-1TT------
--TT----TT
--TT-k--TT
XXXXXXXXXX
XXXXXXXXXX
