----------
----------
----------
----------
----------
----------
----------
----------
----------
----------
--!-----S-
----------
----------
----------
XXXXXXXXXX
XXXXXXXXXX