----------
----------
----------
----------
----------
----------
----------
----------
----------
--------oo
----------
-----TT---
-----TT---
--y--TT---
XXXXXXXXXX
XXXXXXXXXX
