----------
----------
----------
----------
----------
----------
----------
----------
----------
----------
----------
----2--@--
----------
----------
X-XX-XX-XX
X-XX-XX-XX
