----------
----------
----------
----------
----------
----------
------SSSS
----------
----------
-------K--
-----SSSSS
T---------
T---------
T---------
XXXXXXXXXX
XXXXXXXXXX
