----------
----------
----------
----------
----------
----------
---------U
----------
----------
----------
--------##
---y-#####
y-######--
######----
XXXX------
XXXX------
