----------
----------
----------
----------
----------
----------
----------
----------
----------
----------
----------
----------
----------
gg-----ggg
XXXXXXXXXX
XXXXXXXXXX
