----------
----------
----------
----------
----------
----------
SS--------
----------
----------
----------
SS--------
K---#----B
----#----b
----#----B
XXXXXXXXXX
XXXXXXXXXX
