----------
----------
----------
----------
----------
----------
----------
----------
----------
----------
----------
----------
----------
----y-y---
XXXXXXXXXX
XXXXXXXXXX
