----------
----------
----------
----------
----------
----------
----------
----------
----------
----1-----
----------
---@------
----------
----------
XXXXXXXXX-
XXXXXXXXX-