----------
----------
----------
----------
----------
----------
----------
----------
----------
----------
----------
--------tt
--------tt
------r-tt
XXXXXXXXXX
XXXXXXXXXX