----------
----------
----------
----------
----------
----------
----------
----------
o---------
----------
----------
--------#-
-------##-
----------
XXXXXXXXXX
XXXXXXXXXX
