----------
----------
----------
----------
----------
----------
#---------
#---------
#---------
#---------
#---------
#---------
#--------F
#--------#
XXXXXXXXXX
XXXXXXXXXX
