----------
----------
----------
----------
----------
----------
----------
----------
----------
----------
Q---------
----------
----------
---------#
XXX--XXXXX
XXX--XXXXX
