----------
----------
----------
----------
----------
--g-------
SSSSSSSS--
----------
----------
----------
----------
----------
----------
----------
XXXXXX---X
XXXXXX---X