----------
----------
----------
----------
----------
----------
----------
----------
----------
----------
----------
----------
---#------
-kk#------
XXXXXXXXXX
XXXXXXXXXX
