----------
----------
----------
----------
----------
----------
----------
----------
----------
SS-?Q-----
----------
----------
-------y--
---SSSSS--
-------XX-
-------XX-
