----------
----------
----------
----------
----------
----------
----------
----------
----------
-------o--
----------
----------
----------
--k-------
-XXXXXXXXX
-XXXXXXXXX
