----------
----------
----------
----------
----------
----------
--------SC
----------
----------
----------
----TT---2
----TT----
----TT----
----TT----
XXXXXXXXXX
XXXXXXXXXX
