----------
----------
----------
----------
----------
----------
----------
----------
----------
----------
----------
----------
----------
----k-ggg-
XXXXXXXXXX
XXXXXXXXXX
