----------
----------
----------
----------
----------
----------
----------
----------
----------
---------o
----------
----------
#---------
#---------
XXXXXXX---
XXXXXXX---
