----------
----------
----------
----------
----------
----------
!S--------
----------
----------
----------
S------#--
------##--
-----###--
----####--
XXXXXXXXXX
XXXXXXXXXX