----------
----------
----------
----------
----------
-----k----
S---SSSSSS
----------
----------
----------
----------
----------
TT--------
TT--------
XXXXXXXX--
XXXXXXXX--
