----------
----------
----------
----------
----------
----------
----------
----------
----------
----------
----------
---------T
-B-------T
-b-------T
XXXXXX--XX
XXXXXX--XX
