----------
----------
----------
----------
----------
----------
---------@
----------
----------
----------
SU----!--!
----------
----------
------k---
XXXXXXXXXX
XXXXXXXXXX