----------
----------
----------
----------
----------
----------
--!-------
----------
----------
----------
S@S!S-----
----------
--------tt
-g------tt
XXXXXXXXXX
XXXXXXXXXX