----------
----------
----------
----------
----------
----------
----------
---y------
-#SS--o---
##--------
##--SC----
##--------
##---SSS--
##--------
XX------XX
XX------XX
