----------
----------
----------
----------
----------
----------
S---------
----------
----------
----------
##--SSC---
----------
----------
----------
XX--XXXXXX
XX--XXXXXX
