----------
----------
----------
----------
----------
----------
----------
----------
---------g
----------
-------S@S
----------
----------
----------
-XXXXXXXXX
-XXXXXXXXX