----------
----------
----------
----------
----------
----------
----------
----------
----------
----------
---------Q
----------
----------
----------
XXXXXXXXXX
XXXXXXXXXX
