----------
----------
----------
----------
----------
----------
SSS-------
----------
----------
----------
----------
----------
------TT--
------TT--
----XXXXXX
----XXXXXX
