----------
----------
----------
----------
----------
----------
USS-------
----------
----------
----------
----------
-B--------
-b-------B
-B-------b
XXXXXXXXXX
XXXXXXXXXX
