----------
----------
----------
----------
----------
----------
----------
----------
----------
----------
--QQQQ----
-------K-B
---------b
---------b
XXXXXXXXXX
XXXXXXXXXX
