----------
----------
----------
----------
----------
----------
-------SSS
----------
----------
--------K-
-------SSS
----------
-TT-------
-TT-------
XXXXXXXXXX
XXXXXXXXXX
