----------
----------
----------
----------
----------
----------
-------SSS
----------
----------
----------
------#---
------#---
------#---
-ggg--#---
XXXXXXXXXX
XXXXXXXXXX
