----------
----------
----------
----------
----------
----------
-SSS!-----
----------
----------
----------
----C-----
----------
----------
-----g-g--
XXXXXXXXXX
XXXXXXXXXX