----------
----------
----------
----------
----------
----------
----------
----------
----------
----------
T-------TT
T-----TTTT
T---TTTTTT
T---TTTTTT
XXXXXXXXXX
XXXXXXXXXX
