----------
----------
----------
----------
----------
----------
----------
----------
-#--------
##-------#
##------##
##-----###
##----####
##---#####
XXXXXXXXXX
XXXXXXXXXX
