----------
----------
----------
----------
----------
----------
----------
----------
----------
----------
----------
----------
----------
----k-----
XXXXXXXXXX
XXXXXXXXXX
