----------
----------
----------
----------
----------
----------
----------
--TT------
--TT------
--TT------
--XX-----T
---------T
---------T
--k------T
XXXXXXXXXX
XXXXXXXXXX
