----------
----------
----------
----------
----------
----------
SCSSS-----
----------
----------
----------
-2----#---
---K--#---
------#---
------#---
XXXXXXXXXX
XXXXXXXXXX
