----------
----------
----------
----------
----------
--g-------
--SSSSS---
----------
----------
----------
----------
----------
--TT-----t
--TT-----t
XXXXXXXXXX
XXXXXXXXXX
