----------
----------
----------
----------
----------
----------
-SSS----S!
----------
----------
----------
---------S
----------
----------
----gg-g-g
XXXXXXXXXX
XXXXXXXXXX