----------
----------
----------
----------
----------
----------
----------
----------
----------
-------SSU
----------
----------
----------
----------
XX-XXXXXXX
XX-XXXXXXX
