----------
----------
----------
----------
----------
----------
----------
----------
----------
----------
----------
-------TT-
-------TT-
-kkk---TT-
XXXXXXXXXX
XXXXXXXXXX
