----------
----------
----------
----------
----------
----------
----------
----------
----------
----------
---------#
--------##
-------###
---y--####
XXXXXXXXXX
XXXXXXXXXX
