----------
----------
----------
----------
----------
----------
----------
----------
----------
----------
----------
----------
----------
----k-k---
XXXXXXXXX-
XXXXXXXXX-
