----------
----------
----------
----------
----------
----------
----------
----------
----------
----------
-----ooo--
----------
----------
----------
--XXXXXXXX
--XXXXXXXX
