----------
----------
----------
----------
----------
----------
----------
----------
----------
----------
-TT---SU--
-TT-------
-TT-------
-TT------k
XXXXXXXXXX
XXXXXXXXXX
