----------
----------
----------
----------
----------
--oo------
----------
----------
----------
----------
----------
----------
--------tt
--ggg---tt
XXXXXXXXXX
XXXXXXXXXX
