----------
----------
----------
----------
----------
----------
----------
----------
----------
----------
!S--------
----------
---------t
----gg---t
XXXXXXXXXX
XXXXXXXXXX