----------
----------
----------
----------
----------
----------
----------
----------
---------o
-----y----
-----##---
----###---
---####---
--#####---
XXXXXXX---
XXXXXXX---
