----------
----------
----------
----------
----------
----------
----------
----------
----------
---------t
-----TT--t
-TT--TT--t
-TT--TT--t
-TT--TT--t
-XX--XX--X
-XX--XX--X
