----------
----------
----------
----------
----------
----------
----------
----------
----------
----------
----------
----------
---------#
------gg##
XXXXXXXXXX
XXXXXXXXXX
