----------
----------
----------
----------
----------
----------
------QQQQ
----------
----------
--------k-
------?QQQ
TT--------
TT--------
TT--------
XXXXXXXXXX
XXXXXXXXXX
