----------
----------
----------
----------
----------
----------
SS--------
----------
----------
---TT-----
---TT-----
t--TT-----
t--TT-----
t--TT-----
XXXXXXXXXX
XXXXXXXXXX
