----------
----------
----------
----------
----------
----------
----------
----------
----------
----------
---------T
---------T
---------T
--gg-----T
XXXXXXXXXX
XXXXXXXXXX
