----------
----------
----------
----------
----------
----------
-------SSS
----------
----------
----------
----C-----
----------
----------
---gg-----
XXXXXXXXXX
XXXXXXXXXX
