----------
----------
----------
----------
----------
----------
----------
----------
----------
----------
--------SU
----------
----------
--M-------
XXXXXXXXXX
XXXXXXXXXX
