----------
----------
----------
----------
----------
----------
---------C
----------
----------
----------
--------SS
T---------
T---------
T--------k
XXXXXXXXXX
XXXXXXXXXX
