----------
----------
----------
----------
----------
----------
SS---?----
----------
----------
----------
---Q------
---------T
---------T
--K-K----T
XXXXXXXXXX
XXXXXXXXXX
