----------
----------
----------
----------
----------
----------
----------
----------
----------
------g---
------TT--
------TT--
------TT--
------TT--
XXXXXXXXX-
XXXXXXXXX-
