----------
----------
----------
----------
----------
----------
-----SSSS-
----------
----------
----------
Q---------
----------
----------
-ggg------
XXXXX----X
XXXXX----X
