----------
----------
----------
----------
----------
----------
----------
----------
----------
----------
----S-----
TT--------
TT--------
TT------k-
XXXXXXXXXX
XXXXXXXXXX
