----------
----------
----------
----------
----------
----------
----------
----------
----------
----------
----------
----------
----------
-------ggg
-XXXXXXXXX
-XXXXXXXXX
