----------
----------
----------
----------
----------
----------
----------
----------
----------
----------
---------#
--------##
TT-----###
TT----####
XXXXXXXXXX
XXXXXXXXXX
