----------
----------
----------
----------
----------
----------
?SSS------
----------
----------
----------
SSSSS-----
----------
----------
--K-------
XXXXXXXXXX
XXXXXXXXXX
