----------
----------
----------
----------
----------
----------
----SSQSSS
----------
----------
------K---
----SSSSSS
----------
----------
----------
XXXXXXXXXX
XXXXXXXXXX
