----------
----------
----------
----------
----------
----------
--SSC-----
----------
----------
--SSS-----
----------
----------
----------
---------#
X----XXXXX
X----XXXXX
