----------
----------
----------
----------
----------
----------
---USS----
----------
----------
----------
--#-------
--#-------
--##------
--##--gg--
--XXXXXXXX
--XXXXXXXX
