----------
----------
----------
----------
----------
----------
----------
----------
---g#-----
--g##-----
--###-----
-####-----
#####-----
#####-----
XXXXX--XXX
XXXXX--XXX
