----------
----------
----------
----------
----------
----------
----------
----------
----------
----------
----------
------G---
------TT--
------TT--
XXXXXXXXXX
XXXXXXXXXX
