----------
----------
----------
----------
----------
----------
----------
--oooo----
----------
----------
T---------
T---------
T---------
T---y-----
XXXXXXXXXX
XXXXXXXXXX
