----------
----------
----------
----------
----------
----------
-QQQQ-----
----------
----------
---y------
Q?SSQQQ---
----------
----------
----------
XX--XXXXXX
XX--XXXXXX
