----------
----------
----------
----------
----------
----------
----------
----------
----------
----------
----------
----------
----------
-y--------
XXXXXXXXXX
XXXXXXXXXX
