----------
----------
----------
----------
----------
----------
--------Q-
----------
----------
----------
--------?-
----TT----
----TT----
----TT----
XXXXXXXXXX
XXXXXXXXXX
