----------
----------
----------
----------
----------
----------
-----1----
----------
----------
----------
---QQQQ---
----------
----------
----yy----
XXXXXXXXXX
XXXXXXXXXX
