----------
----------
----------
----------
----------
----------
----------
----------
----------
----------
----------
----------
-----*----
-----*----
XXXXXXXXXX
XXXXXXXXXX
