----------
----------
----------
----------
----------
----------
----------
----------
----------
----------
----------
----------
------*---
gg----*---
XXXXXXXXX-
XXXXXXXXX-
