----------
----------
----------
----------
----------
----------
----------
----------
----------
----------
----------
----------
----------
-----ggg--
XXXXXXXXXX
XXXXXXXXXX
