----------
----------
----------
----------
----------
----------
----------
----------
----------
----------
----------
---------T
---------T
-------kkT
XXXXXXXXXX
XXXXXXXXXX
