----------
----------
----------
----------
----------
----------
----------
----------
----------
----------
----------
----------
----------
gg--------
XXXXXXXXXX
XXXXXXXXXX
