----------
----------
----------
----------
----------
----------
----------
----------
----------
----------
----------
----------
----------
-k----ggg-
XXXXXXXXXX
XXXXXXXXXX
