----------
----------
----------
----------
----------
----------
----------
----------
----------
-------K--
----------
---------#
--------##
-K-----###
XXXXXXXXXX
XXXXXXXXXX
