----------
----------
----------
----------
----------
----------
----------
----------
----------
----------
----------
----------
----------
gg-------g
XXXXXXXXXX
XXXXXXXXXX
