----------
----------
----------
----------
----------
----------
----------
----------
----------
----------
----------
----------
----------
---------g
-XXXXXXXXX
-XXXXXXXXX
