----------
----------
----------
----------
----------
----------
----------
----------
----------
----------
----------
----------
----------
---M------
XXXXXXXXXX
XXXXXXXXXX