----------
----------
----------
SSSSSSSSSS
----------
----------
----------
----------
----------
----------
@QQQQ-----
-------g--
-----g-#-#
-----#-#-#
XXXXXXXXXX
XXXXXXXXXX
