----------
----------
----------
SSSSSSSSSS
--SS----SS
--SS----SS
--SS----SS
--SS------
----------
----------
-------TT-
--TT---TT-
--TT---TT-
--TT---TT-
XXXXXXXXXX
XXXXXXXXXX
