----------
----------
----------
SSSSSSSS--
----------
----------
----------
----------
----------
----------
-----g##--
-----###--
---g####--
---#####--
XXXXXXXX--
XXXXXXXX--
