----------
----------
----------
SSSSSSSSSS
----------
----------
----------
----------
----------
----------
-----g##--
-----###--
---g####--
---#####--
XXXXXXXX--
XXXXXXXX--
