----------
----------
----------
SSSSSSSSSS
----------
----------
SSSSSSSSSS
----------
----------
-----SSSSS
----------
----------
-SSS------
-------r--
-----XXXXX
-----XXXXX
