----------
----------
----------
----------
----------
----------
SSS-------
----------
----------
-----SSSSS
----------
----------
SSS-------
-------r--
-----XXXXX
-----XXXXX
