----------
----------
----------
SSSSSSSSSS
----------
----------
QQ--------
----------
----------
----------
QQ--QQQ---
----------
----------
----------
XXXXXXX---
XXXXXXX---
