----------
----------
----------
SSSSSSSSSS
----------
----------
----------
----C-----
----------
----------
---#-#----
-#-#-#-#--
-#-#-#-#--
-#-#-#-#-g
XXXXXXXXXX
XXXXXXXXXX
