----------
----------
----------
SSSSSSSSSS
----------
----------
----CSS---
----------
-SS-------
---222----
------22--
----------
----------
----------
---XXXXXXX
---XXXXXXX
