----------
----------
----------
SSSSSSSSSS
----------
----------
----------
----------
----------
-------S--
----------
---TT---tt
---TT---tt
--kTT--ktt
XXXXXXXXXX
XXXXXXXXXX
