----------
----------
----------
SSSSSSSSSS
----------
----------
----------
----------
----------
------SS--
----------
---TT---tt
---TT---tt
--kTT--ktt
XXXXXXXXXX
XXXXXXXXXX
