----------
----------
----------
SSSSSSSSSS
----------
----------
----------
----------
----------
----------
-------TT-
----#--TT-
---##--TT-
kk-##--TT-
XXXXX--XX-
XXXXX--XX-
