----------
----------
----------
SSSSSSSSSS
----------
----------
----------
----------
-----SSS--
----------
----------
-##-------
-##-------
-##-------
-XX-----XX
-XX-----XX
