----------
----------
----------
SSSSSSSSSS
----------
----------
-SUS------
----------
----SSS---
----------
SSSS------
----------
----------
----------
XXX-----XX
XXX-----XX
