----------
----------
----------
SSSSSSSSSS
----------
----------
----------
----------
----------
----------
----------
-#--------
-#-#------
-#-#------
XXXXXXXXXX
XXXXXXXXXX
