----------
----------
----------
SSSSSSSSSS
SSSSSSSSSS
SSSSSSSSSS
SSSSSSSSSS
----------
----------
--ooooooo-
-USS@SSSSS
----------
----------
--------kk
XXXXXXXXXX
XXXXXXXXXX
