----------
----------
----------
SSSSSSSSSS
SSSSSS----
SSSSSS----
SSSSSS----
----------
----------
----------
------#---
-----##---
----###---
---####--k
XXXXXXXXXX
XXXXXXXXXX
