----------
----------
----------
SSSSSSSSSS
----------
----------
-oooooooo-
----------
-S-SSSS-U-
-SoS--SoS-
-SSS--SSS-
----------
----------
--k----k--
XXXXXXXXXX
XXXXXXXXXX
