----------
----------
----------
SSSSSSSSSS
----------
----------
-oooo-----
----------
S-SSSS-U--
SoS--SoS--
SSS--SSS--
----------
----------
--kk------
XXXXXXXXXX
XXXXXXXXXX
