----------
----------
----------
SSSSSSSSSS
-----SSSSS
--G--SSSS-
-SS-------
-SS-------
-SS-------
-SC--g-g-g
-SS--SSSSS
----------
----------
----------
XXXXXXXXXX
XXXXXXXXXX
