----------
----------
----------
SSSSSSSSSS
----------
----------
----oooooo
----------
----SSSSSS
----SSSSSS
----------
----------
----------
----------
---XXXXXXX
---XXXXXXX
