----------
----------
----------
SSSSSSSSSS
----------
----------
----------
----------
----------
----------
----------
----------
----------
-----g-g-g
XXXXXXXXXX
XXXXXXXXXX
