--------
--------
--------
SSSS---S
-------S
-------S
-------S
TT-----S
TT-----S
TT-----S
TT----FS
TT---SSS
TT---SSS
TT---SSS
XXX--XXX
XXX--XXX