--------
--------
--------
SSSS---S
-------S
-------S
-------S
-------S
-------S
-------S
-------S
-------S
-------S
------FS
XXX--XXX
XXX--XXX