--------
--------
--------
--------
--------
--------
--------
--------
--------
--------
--------
--------
--------
------F-
XXX--XXX
XXX--XXX