----------
----------
----------
SSSSSSSSSS
----------
----------
----------
----------
----------
----------
--------TT
--TT----TT
--TT----TT
--TT----TT
XXXXXXXXXX
XXXXXXXXXX
