----------
----------
----------
SSSSSSSSSS
----------
----------
----------
----------
----------
----------
T---------
T---------
T----TT---
T--g-TT---
XXXXXXXXXX
XXXXXXXXXX
