----------
----------
----------
SSSSSSSSSS
----------
----------
-oooo-----
----------
-SSSS-U---
oS--SoS---
SS--SSS---
----------
----------
--kk------
XXXXXXXXXX
XXXXXXXXXX
