----------
----------
----------
SSSSSSSSSS
----------
----------
----------
----------
----------
----------
----------
----------
-----TT---
---g-TT---
XXXXXXXXXX
XXXXXXXXXX
