----------
----------
----------
SSSSSSSSSS
----SS--SS
----SS--SS
--SS------
--SS------
--SS------
--SS----oo
--SSSS--SS
----SS----
----SS----
----------
XXXXXXXXXX
XXXXXXXXXX
