----------
----------
----------
SSSSSSSSSS
----------
----------
----------
------TT--
------TT--
------TT--
----SCTTCS
TT----TT--
TT----TT--
TT---kTT--
XXXXXXXXXX
XXXXXXXXXX
