----------
----------
----------
S-----SSSS
S---------
S---------
S---------
S---------
S---------
S---------
S---------
S---------
S---------
S---------
XXXXXXXXXX
XXXXXXXXXX
