----------
----------
----------
SS-------S
----------
----------
---------S
----------
-----SSS--
----------
---------S
-##-------
-##-------
-##-------
-XX------X
-XX------X
