----------
----------
----------
SS-----SSS
----------
----------
----------
----------
-----SSS--
----------
----------
-##-------
-##-------
-##-------
-XX-----XX
-XX-----XX
