----------
----------
----------
SSS-----SS
----------
----------
SUS-------
----------
----SSS---
----------
SSSS------
----------
----------
----------
XXX-----XX
XXX-----XX
