----------
----------
----------
SSSSSSS---
----------
----------
QQ--------
----------
---------S
----------
QQ--QQQ---
----------
----------
----------
XXXXXXX---
XXXXXXX---
