----------
----------
----------
SSSSSSSSSS
SSSSSSSSSS
SSSSSSSSSS
SSSSSSSSSS
----------
----------
----------
--SSSSSS?-
--SSSSS---
--SSSSS---
-------ooo
-XXXXXXXXX
-XXXXXXXXX
