----------
----------
----------
SSSSSSSSSS
----------
----------
----------
----------
----------
----------
----------
t---------
t---------
t---------
XXXXXXXXXX
XXXXXXXXXX
