----------
----------
----------
SSSSSSSSSS
----------
----------
----------
----------
----------
----------
----------
----------
----------
----------
XXXXXXXXXX
XXXXXXXXXX
