----------
----------
----------
----------
----------
----------
--------G-
----------
-------%%%
--------||
--------||
---%%%%%||
----|||-||
--2-|||-||
X---|||-||
X---|||-||
