----------
----------
----------
----------
----------
--USSS----
----------
-g--------
%%%-------
||----SSS-
||--------
||--------
||--------
||----oo--
||---%%%--
||----|---
