----------
----------
----------
----------
----------
----------
----------
--o----ooo
----------
----------
----L-----
----------
----------
-%%%%%%%--
--|||||---
--|||||---
