----------
----------
----------
----------
----------
----------
----SS----
-------U--
----------
----------
SS-----SS-
----------
----SS----
----------
----------
----------
