----------
----------
----------
----------
----------
------@U1-
----------
----------
------SSS-
----------
%%%%%-----
-|||------
-|||------
-|||------
-|||--%%%-
-|||---|--
