----------
----------
----------
----------
----------
----------
-----oo---
----------
----G-----
----------
-%%%%--%%%
--||----||
--||----||
--||-G-%%|
%%%%----||
--||----||
