----------
----------
----------
----------
o---------
----------
-%%%%-----
--||------
--||------
--||------
--||------
--||------
--||------
--||------
--||-XXXXX
--||-XXXXX
