----------
----------
----------
--oo------
-------g-g
-----%%%%%
------||||
------||||
------||||
%%%%%-||||
-|||--||||
-|||--||||
-|||--||||
-|||--||||
-|||--||||
-|||--||||
