----------
----------
----------
----------
----------
----------
----------
---SSS----
----------
----------
----------
----------
----------
----------
%%%%----%%
|||------|
