----------
----------
----------
----------
----------
----------
--oo---%%%
--SS----||
--------||
--------||
-----SS-||
--------||
--------||
--------||
%%-----%%%
|-------||
