----------
----------
----------
----------
----------
----------
----------
----------
----------
--------K-
--%%%%%%--
---||||---
---||||---
---||||---
%%-||||-%%
|--||||--|
