----------
----------
----------
----------
----------
--ooor----
-%%%%%----
--|||-----
--|||-----
--|||-----
%%%%%%%---
||||||----
||||||--o-
||||||-%%%
||||||--|-
||||||--|-
