----------
----------
----------
----------
----------
----------
---------R
-r--------
%%%%%%%---
||||||----
||||||----
||||||----
||||||----
||||||--oo
||||||--%%
||||||---|
