----------
----------
----------
----------
----------
--------oo
-----SSSS-
----------
----------
----------
%---------
----------
----------
----------
--%%%%--%%
---||----|
