----------
----------
----------
----------
----------
--oo------
----------
----------
---------%
----------
S---------
----------
---%%%%---
----||----
----||----
----||----
