----------
----------
----------
ooo-------
%%%-------
-|--------
-|----@@@-
-|--------
-|--------
-|---%%%%-
-|----||--
%%%%%%||--
-||||-||--
-||||-||--
-||||-||--
-||||-||--
