----------
----------
----------
----------
----------
----------
----------
----------
----------
----------
---------%
----------
----------
---%%%%---
X---||----
X---||----
