----------
----------
----------
----------
----------
----------
----------
----------
----------
-----oooo-
----------
----------
---------R
-----gg---
%%%%%%%%%%
||||||||||
