----------
----------
----------
----------
----------
----------
----------
----------
------SSS-
----------
%---------
----------
----------
---------r
----XXXXXX
----XXXXXX
