----------
----------
----------
----------
----------
---------R
----------
----------
----------
----------
-----%%%--
------|---
------|---
------|---
%%%%%-|---
-|||--|---
