----------
----------
----------
----------
----------
--oo------
----------
----------
----------
----------
SS--oooo--
----------
---%%%%---
----||----
----||----
----||----
