----------
----------
----------
----------
----------
----------
----------
----------
----------
----------
----------
----------
----------
--%%%%%%--
----||----
----||----
