----------
----------
----------
----------
----------
----------
-----oo---
----------
-2222-----
----------
-%%%%--%%%
--||----||
--||----||
--||----||
--||----||
--||----||
