----------
----------
----------
----------
----------
----------
----------
----------
----------
----------
----------
----------
-------F--
-------#--
XXXXXXXXXX
XXXXXXXXXX
