----------
----------
----------
----------
----------
----------
-----oo---
----------
----------
----------
-%%%%--%%%
--||----||
--||----||
o-||----||
%-||----||
--||----||
