----------
----------
----------
----------
-g--------
%%--------
|---------
|----oo---
|---------
|---------
|---------
|---------
|---------
|---------
|----%%%%-
|-----||--
