----------
----------
----------
----------
----------
--1-------
---------R
-----r----
%%%%%%%---
||||||----
||||||----
||||||----
||||||----
||||||--oo
||||||--%%
||||||--||
