----------
----------
----------
----------
----------
----------
-------G--
----------
----------
-%%%%%%---
--||||----
--||||----
--||||----
--||||----
--||||----
--||||----

