----------
----------
----------
----------
----------
----------
----------
-o---o---o
%%%-%%%-%%
-|---|---|
-|---|---|
-|---|---|
-|---|---|
-|---|-r-|
%%%%%%%%%%
-|||||||||
