----------
----------
----------
----------
----?-----
----------
----------
------r---
--%%%%%%--
---||||---
%%-||||ooo
|--||||--r
|%%%%%%%%%
|-||||||||
|-||||||||
|-||||||||
