----------
----------
----------
----------
----------
----------
----------
----------
----------
----------
----------
----%%%%%%
-----|||||
-----|||||
-%%%-|||||
--|--|||||
