----------
----------
----------
----------
----------
----------
----------
--o----ooo
----------
----------
--------%%
---------|
---------|
-%%%%%%%-|
--|||||--|
--|||||--|
