----------
----------
----------
----------
----------
----------
SSS------%
----------
----------
----------
--%%%-----
---|------
---|------
---|------
---|------
---|------
