---------

---------

---------

---------

---------

---------

---------

---------

---------

---------

---------

---------

-------F-

-------#-

XXXXXXXXX

XXXXXXXXX
