----------
----------
----------
----------
----?-----
----------
----------
------r---
--%%%%%%--
---||||-21
---||||ooo
---||||--r
-%%%%%%%%%
-|||||||||
-|||||||||
-|||||||||
