----------
----------
----------
----------
----------
----------
----------
----------
-----SSS--
----------
r---------
%%%%%%----
|||||-----
|||||-----
|||||-----
|||||-----
