----------
----------
----------
----------
----------
----------
SSS-------
----------
----------
----------
--%%%-----
---|------
---|------
---|---%%%
---|----|-
---|----|-
