----------
----------
----------
----------
----------
oo--------
%%%-------
||--o----R
||-%%%----
||--|-----
||--|-----
||-o|-----
||%%%%%---
||-|||----
||-|||----
||-|||----
