----------
----------
----------
----------
----------
----------
---o--o---
----------
----------
---SSSS---
----------
----------
%%%-------
||--------
||--------
||--------
