----------
----------
----------
----------
----------
----------
----------
----------
----------
----------
----------
--M-------
----------
----------
XXXXXXXXXX
XXXXXXXXXX
